{	"numX": 13,	"numY": 9,	"size": [64, 64],	"start": [32, 32],	"tileNames": ["", "ProtoCoin", "ProtoBox", "ProtoTile01", "ProtoBat", "ProtoTile02"],	"tiles": [3, 0, 0, 0, 0, 0, 0, 0, 0, 0, 0, 0, 3,
			  3, 0, 1, 0, 0, 1, 1, 1, 0, 0, 1, 4, 3,
			  3, 0, 0, 0, 0, 3, 3, 3, 0, 0, 0, 0, 3,
			  3, 0, 0, 0, 0, 0, 0, 0, 0, 0, 0, 0, 3,
			  3, 0, 0, 1, 0, 0, 0, 0, 0, 1, 0, 0, 3,
			  3, 0, 0, 5, 0, 0, 0, 0, 0, 5, 0, 0, 3,
			  3, 0, 0, 0, 0, 0, 0, 0, 0, 0, 0, 0, 3,
			  3, 1, 0, 0, 0, 3, 3, 3, 0, 0, 0, 1, 3,
			  3, 3, 5, 3, 3, 3, 3, 3, 3, 3, 5, 3, 3]
}